00000000000000000000
00000000000000000000
00000000000000000000
00000000000000000000
00000000000000000000
00000000000000000000
00000001111000000000
00000001001000000000
00000001001000000000
00000001001000000000
00000001111000000000
00000000110000000000
00000000110000000000
00000000110000000000
00000000110000000000
00000000000000000000
00000000000000000000
00000000000000000000
00000000000000000000
00000000000000000000
